season_1 = {
    "season_id" : 1,
    "icon_url" : "season_1",
    "r" : 149,
    "g" : 13,
    "b" : 0,
    "sr" : 95,
    "sg" : 15,
    "sb" : 13,
    "sa" : 255,
    "levels" :
    [
     {
     "level_id" : 1,
     "matrix" :
     [
      [1, 1, 1, 1, 1, 1, 1],		 
      [1, 0, 0, 0, 0, 3, 1],
      [1, 0, 0, 0, 0, 0, 1],
      [1, 0, 0, 0, 0, 0, 1],
      [1, 0, 0, 0, 0, 0, 1],
      [1, 0, 0, 0, 0, 0, 1],
      [1, 2, 0, 0, 0, 0, 1],
	  [1, 1, 1, 1, 1, 1, 1]
      ]
     },
     {
     "level_id" : 2,
     "matrix" :
                             [
                              [1, 1, 1, 1, 1, 1, 1],
                              [1, 0, 0, 0, 0, 0, 1],
                              [1, 0, 0, 0, 0, 0, 1],
                              [1, 3, 0, 0, 0, 0, 1],
                              [1, 1, 1, 1, 1, 0, 1],
                              [1, 0, 0, 0, 0, 0, 1],
                              [1, 0, 0, 0, 0, 0, 1],
                              [1, 2, 0, 0, 0, 0, 1],
                              [1, 1, 1, 1, 1, 1, 1]
                              ]
     },
     {
     "level_id" : 3,
     "matrix" :
                                                     [
                                                      [1, 1, 1, 1, 1, 1, 1],
                                                      [1, 0, 0, 0, 0, 0, 1],
                                                      [1, 0, 0, 0, 0, 1, 1],
                                                      [1, 3, 3, 3, 0, 0, 1],
                                                      [1, 0, 0, 1, 0, 0, 1],
                                                      [1, 0, 0, 0, 0, 0, 1],
                                                      [1, 0, 0, 0, 0, 0, 1],
                                                      [1, 1, 0, 0, 0, 0, 1],
                                                      [1, 2, 0, 0, 1, 1, 1],
                                                      [1, 1, 1, 1, 1, 1, 1]
                                                      ]
     },
     {
     "level_id" : 4,
     "matrix" :
                                                                             [
                                                                              [1, 1, 1, 1, 1, 1, 1],
                                                                              [1, 0, 0, 0, 0, 0, 1],
                                                                              [1, 0, 0, 0, 0, 0, 1],
                                                                              [1, 0, 0, 1, 1, 0, 1],
                                                                              [1, 3, 3, 0, 0, 0, 1],
                                                                              [1, 1, 1, 0, 0, 0, 1],
                                                                              [1, 0, 0, 0, 0, 0, 1],
                                                                              [1, 0, 0, 0, 0, 0, 1],
                                                                              [1, 2, 0, 0, 0, 0, 1],
                                                                              [1, 1, 1, 1, 1, 1, 1]
                                                                              ]
     },

     {
     "level_id" : 5,
     "matrix" :
    [
     [1, 1, 1, 1, 1, 1, 1],
     [1, 0, 0, 0, 0, 0, 1],
     [1, 0, 0, 0, 0, 0, 1],
     [1, 0, 0, 0, 0, 0, 1],
     [1, 0, 0, 0, 0, 0, 1],
     [1, 0, 0, 0, 0, 0, 1],
     [1, 0, 0, 0, 1, 3, 1],
     [1, 2, 0, 0, 1, 3, 1],
     [1, 1, 1, 1, 1, 1, 1]
     ]
     },
     {
     "level_id" : 6,
     "matrix" :
                             [
                              [1, 1, 1, 1, 1, 1, 1, 1, 1],
                              [1, 0, 0, 0, 1, 3, 3, 3, 1],
                              [1, 0, 0, 0, 1, 0, 0, 0, 1],
                              [1, 0, 1, 0, 0, 0, 0, 0, 1],
                              [1, 0, 0, 0, 0, 0, 0, 0, 1],
                              [1, 0, 0, 0, 0, 0, 0, 0, 1],
                              [1, 0, 0, 1, 0, 0, 0, 0, 1],
                              [1, 0, 0, 1, 0, 0, 0, 0, 1],
                              [1, 2, 0, 1, 0, 0, 0, 0, 1],
                              [1, 1, 1, 1, 1, 1, 1, 1, 1]
                              ]
     },
     {
     "level_id" : 7,
     "matrix" :
                                                        [
                                                         [1, 1, 1, 1, 1, 1, 1],
                                                         [1, 0, 0, 0, 0, 2, 1],
                                                         [1, 0, 0, 0, 0, 0, 1],
                                                         [1, 0, 0, 0, 0, 0, 1],
                                                         [1, 0, 0, 0, 0, 0, 1],
                                                         [1, 0, 0, 1, 1, 0, 1],
                                                         [1, 1, 3, 0, 0, 0, 1],
                                                         [1, 0, 0, 0, 0, 0, 1],
                                                         [1, 0, 0, 0, 0, 0, 1],
                                                         [1, 1, 1, 1, 1, 1, 1]
                                                         ]
     },
     {
     "level_id" : 8,
     "matrix" :
                                                                                [
                                                                                 [1, 1, 1, 1, 1, 1, 1, 1, 1, 1],
                                                                                 [1, 0, 0, 0, 0, 1, 0, 0, 1, 1],
                                                                                 [1, 0, 0, 0, 0, 1, 0, 0, 0, 1],
                                                                                 [1, 0, 1, 1, 0, 0, 0, 1, 0, 1],
                                                                                 [1, 0, 0, 0, 0, 3, 1, 2, 0, 1],
                                                                                 [1, 0, 0, 0, 0, 0, 0, 0, 0, 1],
                                                                                 [1, 0, 1, 1, 0, 0, 0, 0, 0, 1],
                                                                                 [1, 0, 0, 0, 0, 1, 1, 0, 0, 1],
                                                                                 [1, 0, 0, 0, 0, 0, 0, 0, 0, 1],
                                                                                 [1, 1, 1, 1, 1, 1, 1, 1, 1, 1]
                                                                                 ]
     },
     {
     "level_id" : 9,
     "matrix" :
     [
      [1, 1, 1, 1, 1, 1, 1, 1, 1],
      [1, 0, 0, 1, 0, 0, 0, 0, 1],
      [1, 0, 0, 2, 1, 0, 0, 0, 1],
      [1, 0, 0, 0, 3, 0, 1, 0, 1],
      [1, 0, 1, 0, 3, 0, 0, 0, 1],
      [1, 0, 0, 0, 3, 1, 0, 0, 1],
      [1, 0, 0, 0, 0, 0, 0, 1, 1],
      [1, 0, 0, 1, 0, 0, 0, 0, 1],
      [1, 0, 0, 0, 0, 0, 0, 0, 1],
      [1, 1, 1, 1, 1, 1, 1, 1, 1]
      ]
     },
     {
     "level_id" : 10,
     "matrix" :
                                     [
                                      [1, 1, 1, 1, 1, 1, 1, 1, 1],
                                      [1, 0, 0, 0, 0, 1, 0, 0, 1],
                                      [1, 0, 2, 1, 0, 0, 1, 0, 1],
                                      [1, 0, 1, 0, 1, 0, 0, 0, 1],
                                      [1, 0, 0, 0, 0, 0, 0, 0, 1],
                                      [1, 0, 0, 0, 1, 0, 0, 1, 1],
                                      [1, 0, 0, 0, 3, 0, 0, 0, 1],
                                      [1, 1, 0, 0, 0, 1, 0, 0, 1],
                                      [1, 1, 1, 0, 0, 0, 0, 0, 1],
                                      [1, 1, 1, 1, 1, 1, 1, 1, 1]
                                      ]
     },
     {
     "level_id" : 11,
     "matrix" :
                                                                     [
                                                                      [1, 1, 1, 1, 1, 1, 1, 1, 1, 1],
                                                                      [1, 0, 0, 0, 0, 1, 0, 0, 0, 1],
                                                                      [1, 0, 1, 1, 0, 0, 0, 1, 0, 1],
                                                                      [1, 0, 1, 0, 3, 3, 1, 1, 0, 1],
                                                                      [1, 0, 0, 0, 3, 3, 0, 0, 0, 1],
                                                                      [1, 0, 1, 0, 0, 0, 0, 0, 0, 1],
                                                                      [1, 0, 0, 0, 0, 0, 0, 0, 0, 1],
                                                                      [1, 1, 1, 0, 0, 0, 0, 0, 1, 1],
                                                                      [1, 1, 1, 2, 1, 0, 0, 1, 1, 1],
                                                                      [1, 1, 1, 1, 1, 1, 1, 1, 1, 1]
                                                                      ]
     },
     {
     "level_id" : 12,
     "matrix" :
                                                                                                         [
                                                                                                          [1, 1, 1, 1, 1, 1, 1, 1, 1, 1, 1],
                                                                                                          [1, 1, 1, 1, 1, 0, 0, 0, 0, 2, 1],
                                                                                                          [1, 1, 1, 1, 0, 0, 0, 0, 1, 0, 1],
                                                                                                          [1, 1, 1, 0, 0, 0, 0, 0, 0, 0, 1],
                                                                                                          [1, 0, 0, 3, 1, 0, 0, 0, 1, 1, 1],
                                                                                                          [1, 0, 1, 0, 0, 0, 0, 0, 0, 0, 1],
                                                                                                          [1, 0, 1, 0, 0, 1, 1, 0, 0, 0, 1],
                                                                                                          [1, 0, 1, 0, 0, 0, 0, 0, 0, 0, 1],
                                                                                                          [1, 0, 1, 0, 0, 0, 0, 0, 0, 1, 1],
                                                                                                          [1, 0, 1, 1, 0, 0, 0, 0, 1, 1, 1],
                                                                                                          [1, 0, 0, 0, 0, 0, 0, 1, 1, 1, 1],
                                                                                                          [1, 0, 0, 1, 0, 1, 0, 1, 1, 1, 1],
                                                                                                          [1, 1, 1, 1, 1, 1, 1, 1, 1, 1, 1]
                                                                                                          ]
     },
     {
     "level_id" : 13,
     "matrix" :
     [
      [1, 1, 1, 1, 1, 1, 1, 1, 1, 1],
      [1, 0, 0, 0, 0, 0, 0, 0, 0, 1],
      [1, 2, 1, 1, 0, 0, 0, 1, 0, 1],
      [1, 1, 0, 0, 0, 0, 0, 0, 0, 1],
      [1, 0, 0, 3, 0, 0, 0, 1, 0, 1],
      [1, 0, 1, 3, 0, 1, 0, 0, 0, 1],
      [1, 0, 0, 0, 1, 0, 0, 0, 1, 1],
      [1, 0, 1, 0, 0, 0, 1, 0, 0, 1],
      [1, 0, 0, 0, 0, 0, 0, 0, 0, 1],
      [1, 1, 1, 1, 1, 1, 1, 1, 1, 1]
      ]
     },
     {
     "level_id" : 14,
     "matrix" :
                                     [
                                      [1, 1, 1, 1, 1, 1, 1, 1, 1, 1],
                                      [1, 2, 0, 0, 0, 0, 0, 0, 0, 1],
                                      [1, 0, 0, 0, 1, 0, 0, 0, 0, 1],
                                      [1, 0, 0, 0, 0, 1, 0, 0, 0, 1],
                                      [1, 0, 0, 1, 0, 0, 0, 0, 0, 1],
                                      [1, 0, 3, 3, 0, 0, 1, 0, 0, 1],
                                      [1, 1, 3, 3, 0, 0, 0, 0, 0, 1],
                                      [1, 0, 0, 0, 0, 1, 0, 0, 0, 1],
                                      [1, 0, 0, 0, 0, 0, 0, 0, 0, 1],
                                      [1, 1, 1, 1, 1, 1, 1, 1, 1, 1]
                                      ]
     },
     {
     "level_id" : 15,
     "matrix" :
	 [
	                                                                                   [1, 1, 1, 1, 1, 1, 1, 1, 1, 1, 1],
	                                                                                   [1, 0, 0, 0, 1, 0, 0, 0, 0, 0, 1],
	                                                                                   [1, 0, 0, 0, 0, 0, 0, 0, 0, 0, 1],
	                                                                                   [1, 1, 0, 0, 1, 1, 1, 0, 0, 0, 1],
	                                                                                   [1, 3, 3, 3, 0, 0, 1, 1, 0, 1, 1],
	                                                                                   [1, 0, 0, 0, 0, 0, 0, 1, 0, 0, 1],
	                                                                                   [1, 1, 0, 1, 1, 0, 0, 0, 0, 0, 1],
	                                                                                   [1, 0, 0, 0, 1, 0, 1, 1, 0, 0, 1],
	                                                                                   [1, 1, 1, 0, 1, 0, 0, 1, 1, 0, 1],
	                                                                                   [1, 2, 0, 0, 0, 0, 0, 1, 0, 0, 1],
	                                                                                   [1, 1, 1, 1, 1, 1, 1, 1, 1, 1, 1]
	                                                                                   ]
     },
     {
     "level_id" : 16,
     "matrix" :
                                                                                                                     [
                                                                                                                      [1, 1, 1, 1, 1, 1, 1, 1, 1, 1, 1],
                                                                                                                      [1, 0, 0, 0, 0, 1, 0, 0, 0, 2, 1],
                                                                                                                      [1, 0, 1, 0, 0, 1, 0, 0, 0, 0, 1],
                                                                                                                      [1, 0, 1, 0, 3, 0, 0, 0, 0, 0, 1],
                                                                                                                      [1, 0, 0, 0, 3, 0, 1, 0, 0, 0, 1],
                                                                                                                      [1, 0, 0, 1, 3, 1, 0, 1, 0, 0, 1],
                                                                                                                      [1, 1, 0, 0, 3, 1, 0, 0, 0, 0, 1],
                                                                                                                      [1, 0, 0, 0, 1, 0, 0, 0, 1, 0, 1],
                                                                                                                      [1, 0, 1, 0, 0, 1, 1, 0, 1, 0, 1],
                                                                                                                      [1, 0, 0, 0, 0, 0, 0, 0, 1, 0, 1],
                                                                                                                      [1, 0, 0, 1, 0, 0, 0, 0, 0, 0, 1],
                                                                                                                      [1, 0, 0, 0, 0, 0, 0, 0, 1, 1, 1],
                                                                                                                      [1, 0, 0, 0, 1, 0, 0, 0, 0, 0, 1],
                                                                                                                      [1, 1, 1, 1, 1, 1, 1, 1, 1, 1, 1]
                                                                                                                      ]
     }
     
     ]
}
