season_2 = {
    "season_id" : 2,
    "icon_url" : "season_2",    
    "r" : 255,
    "g" : 110,
    "b" : 39,
    "sr" : 127,
    "sg" : 56,
    "sb" : 22,
    "sa" : 255,
    "levels" :
    [
     {
     "level_id" : 17,
     "matrix" :
      [
       [1, 3, 0, 0, 0, 3, 1],
       [1, 0, 0, 0, 0, 0, 1],
       [1, 0, 0, 0, 0, 0, 1],
       [1, 0, 0, 0, 0, 0, 1],
       [1, 0, 0, 0, 0, 0, 1],
       [1, 2, 0, 0, 0, 2, 1]
       ]
     },
     {
     "level_id" : 18,
     "matrix" :
                              [
                               [1, 1, 1, 1, 1, 1, 1],
                               [1, 3, 0, 0, 3, 0, 1],
                               [1, 0, 0, 0, 0, 0, 1],
                               [1, 0, 0, 0, 0, 0, 1],
                               [1, 0, 0, 0, 0, 0, 1],
                               [1, 0, 0, 0, 0, 0, 1],
                               [1, 2, 0, 0, 0, 2, 1],
                               [1, 1, 1, 1, 1, 1, 1]
                               ]
     },
     {
     "level_id" : 19,
     "matrix" :
                                                     [
                                                      [1, 1, 1, 1, 1, 1, 1, 1],
                                                      [1, 3, 3, 3, 1, 0, 3, 1],
                                                      [1, 3, 3, 3, 1, 0, 0, 1],
                                                      [1, 3, 3, 3, 1, 0, 0, 1],
                                                      [1, 0, 0, 0, 0, 0, 0, 1],
                                                      [1, 0, 0, 0, 0, 0, 0, 1],
                                                      [1, 0, 0, 0, 0, 0, 0, 1],
                                                      [1, 2, 0, 0, 0, 0, 2, 1],
                                                      [1, 1, 1, 1, 1, 1, 1, 1]
                                                     ]
     },
     {
     "level_id" : 20,
     "matrix" :
                                                                                 [
                                                                                  [1, 1, 1, 1, 1, 1, 1, 1],
                                                                                  [1, 0, 0, 1, 1, 3, 0, 1],
                                                                                  [1, 0, 0, 0, 0, 0, 0, 1],
                                                                                  [1, 0, 1, 3, 0, 0, 0, 1],
                                                                                  [1, 0, 1, 0, 0, 1, 0, 1],
                                                                                  [1, 0, 0, 0, 0, 1, 0, 1],
                                                                                  [1, 0, 0, 0, 0, 0, 0, 1],
                                                                                  [1, 2, 0, 0, 0, 0, 2, 1],
                                                                                  [1, 1, 1, 1, 1, 1, 1, 1]
                                                                                  ]
     },
     {
     "level_id" : 21,
     "matrix" :
      [
       [1, 1, 1, 1, 1, 1, 1, 1, 1],
       [1, 1, 0, 0, 0, 0, 0, 0, 1],
       [1, 0, 0, 0, 0, 0, 0, 0, 1],
       [1, 0, 0, 0, 0, 0, 1, 0, 1],
       [1, 0, 1, 0, 1, 0, 3, 1, 1],
       [1, 0, 0, 0, 3, 1, 0, 0, 1],
       [1, 0, 0, 0, 0, 0, 0, 0, 1],
       [1, 0, 0, 1, 0, 0, 0, 0, 1],
       [1, 2, 0, 0, 0, 0, 0, 2, 1],
       [1, 1, 1, 1, 1, 1, 1, 1, 1]
       ]
     },
     {
     "level_id" : 22,
     "matrix" :
                                      [
                                       [1, 1, 1, 1, 1, 1, 1, 1, 1, 1],
                                       [1, 1, 1, 0, 0, 0, 0, 0, 2, 1],
                                       [1, 0, 0, 0, 0, 0, 0, 0, 0, 1],
                                       [1, 0, 0, 1, 0, 0, 0, 0, 0, 1],
                                       [1, 0, 0, 1, 0, 0, 0, 1, 0, 1],
                                       [1, 0, 0, 3, 0, 1, 0, 0, 0, 1],
                                       [1, 0, 0, 0, 0, 1, 0, 0, 1, 1],
                                       [1, 0, 1, 0, 0, 1, 0, 0, 0, 1],
                                       [1, 0, 0, 0, 0, 3, 0, 0, 0, 1],
                                       [1, 2, 0, 0, 1, 0, 0, 1, 0, 1],
                                       [1, 1, 1, 1, 1, 1, 1, 1, 1, 1]
                                       ]
     },
     {
     "level_id" : 23,
     "matrix" :
                                                                          [
                                                                           [1, 1, 1, 1, 1, 1, 1, 1, 1, 1],
                                                                           [1, 1, 0, 1, 0, 0, 0, 0, 1, 1],
                                                                           [1, 0, 0, 0, 0, 0, 0, 0, 0, 1],
                                                                           [1, 0, 0, 0, 3, 0, 0, 0, 0, 1],
                                                                           [1, 0, 0, 2, 1, 0, 0, 0, 0, 1],
                                                                           [1, 1, 0, 1, 0, 0, 3, 0, 0, 1],
                                                                           [1, 0, 0, 0, 0, 0, 1, 0, 0, 1],
                                                                           [1, 0, 1, 1, 0, 1, 2, 0, 0, 1],
                                                                           [1, 0, 0, 0, 0, 0, 0, 0, 1, 1],
                                                                           [1, 0, 0, 0, 0, 0, 0, 0, 0, 1],
                                                                           [1, 1, 0, 1, 0, 0, 1, 0, 0, 1],
                                                                           [1, 1, 1, 1, 1, 1, 1, 1, 1, 1]
                                                                           ]
     },
     {
     "level_id" : 24,
     "matrix" :
                                                                                                              [
                                                                                                               [1, 1, 1, 1, 1, 1, 1, 1, 1, 1],
                                                                                                               [1, 0, 0, 0, 0, 1, 0, 0, 0, 1],
                                                                                                               [1, 0, 0, 1, 0, 1, 0, 0, 0, 1],
                                                                                                               [1, 0, 1, 2, 3, 0, 0, 0, 3, 1],
                                                                                                               [1, 0, 0, 0, 0, 0, 1, 1, 0, 1],
                                                                                                               [1, 0, 0, 0, 0, 0, 0, 0, 0, 1],
                                                                                                               [1, 0, 1, 1, 0, 0, 1, 0, 0, 1],
                                                                                                               [1, 0, 0, 0, 0, 0, 0, 0, 0, 1],
                                                                                                               [1, 0, 0, 0, 0, 0, 2, 1, 0, 1],
                                                                                                               [1, 0, 1, 0, 1, 0, 1, 0, 0, 1],
                                                                                                               [1, 0, 0, 0, 1, 0, 0, 0, 0, 1],
                                                                                                               [1, 1, 1, 1, 1, 1, 1, 1, 1, 1]
                                                                                                               ]
     },
     {
     "level_id" : 25,
     "matrix" :
     [
      [1, 1, 1, 1, 1, 1, 1, 1, 1],
      [1, 1, 0, 1, 3, 0, 0, 1, 1],
      [1, 2, 0, 1, 0, 0, 0, 0, 1],
      [1, 0, 0, 0, 0, 0, 0, 0, 1],
      [1, 0, 0, 0, 3, 1, 1, 0, 1],
      [1, 0, 1, 1, 0, 0, 0, 0, 1],
      [1, 0, 0, 0, 0, 0, 0, 0, 1],
      [1, 0, 0, 0, 0, 1, 0, 2, 1],
      [1, 1, 0, 0, 0, 1, 0, 1, 1],
      [1, 1, 1, 1, 1, 1, 1, 1, 1]
      ]
     },
     {
     "level_id" : 26,
     "matrix" :
                                     [
                                      [1, 1, 1, 1, 1, 1, 1, 1, 1],
                                      [1, 0, 0, 0, 0, 0, 1, 0, 1],
                                      [1, 3, 0, 0, 0, 0, 0, 0, 1],
                                      [1, 1, 1, 1, 0, 0, 0, 0, 1],
                                      [1, 2, 0, 0, 0, 0, 0, 0, 1],
                                      [1, 3, 0, 0, 0, 0, 0, 2, 1],
                                      [1, 0, 0, 0, 0, 1, 1, 1, 1],
                                      [1, 0, 0, 0, 0, 0, 0, 0, 1],
                                      [1, 0, 1, 0, 0, 0, 0, 0, 1],
                                      [1, 1, 1, 1, 1, 1, 1, 1, 1]
                                      ]
     },
     {
     "level_id" : 27,
     "matrix" :
                                                                   [
                                                                    [1, 1, 1, 1, 1, 1, 1, 1, 1, 1],
                                                                    [1, 2, 0, 0, 0, 0, 0, 0, 0, 1],
                                                                    [1, 0, 0, 0, 1, 1, 0, 0, 2, 1],
                                                                    [1, 0, 1, 0, 0, 0, 0, 1, 0, 1],
                                                                    [1, 0, 1, 0, 0, 0, 0, 1, 0, 1],
                                                                    [1, 0, 0, 0, 1, 0, 0, 0, 0, 1],
                                                                    [1, 0, 0, 0, 0, 0, 3, 1, 0, 1],
                                                                    [1, 0, 1, 0, 0, 0, 1, 1, 0, 1],
                                                                    [1, 0, 1, 1, 0, 0, 0, 0, 0, 1],
                                                                    [1, 0, 0, 0, 3, 1, 0, 0, 0, 1],
                                                                    [1, 0, 0, 0, 1, 1, 0, 0, 0, 1],
                                                                    [1, 0, 0, 0, 0, 0, 0, 0, 0, 1],
                                                                    [1, 1, 1, 1, 1, 1, 1, 1, 1, 1]
                                                                   ]
     },
     {
     "level_id" : 28,
     "matrix" :
                                                                                                     [
                                                                                                      [1, 1, 1, 1, 1, 1, 1, 1, 1, 1],
                                                                                                      [1, 0, 0, 0, 1, 1, 0, 0, 0, 1],
                                                                                                      [1, 0, 0, 0, 0, 0, 0, 0, 0, 1],
                                                                                                      [1, 1, 0, 0, 0, 0, 1, 0, 2, 1],
                                                                                                      [1, 0, 0, 0, 0, 3, 1, 0, 0, 1],
                                                                                                      [1, 0, 0, 0, 0, 0, 0, 0, 0, 1],
                                                                                                      [1, 0, 0, 3, 1, 1, 0, 0, 0, 1],
                                                                                                      [1, 0, 0, 0, 0, 0, 0, 0, 0, 1],
                                                                                                      [1, 0, 0, 1, 0, 0, 0, 0, 0, 1],
                                                                                                      [1, 2, 0, 1, 0, 0, 0, 0, 1, 1],
                                                                                                      [1, 0, 0, 0, 0, 0, 0, 0, 0, 1],
                                                                                                      [1, 0, 0, 0, 1, 1, 0, 0, 0, 1],
                                                                                                      [1, 1, 1, 1, 1, 1, 1, 1, 1, 1]
                                                                                                      ]
     },
     {
     "level_id" : 29,
     "matrix" :
     [
      [1, 1, 1, 1, 1, 1, 1, 1, 1, 1],
      [1, 3, 1, 1, 1, 1, 1, 1, 3, 1],
      [1, 0, 1, 1, 1, 1, 1, 1, 0, 1],
      [1, 0, 1, 1, 1, 1, 1, 1, 0, 1],
      [1, 0, 1, 1, 1, 1, 1, 1, 0, 1],
      [1, 0, 1, 1, 1, 1, 1, 1, 0, 1],
      [1, 0, 1, 2, 0, 0, 2, 1, 0, 1],
      [1, 0, 0, 0, 0, 0, 0, 0, 0, 1],
      [1, 1, 0, 0, 0, 0, 0, 0, 1, 1],
      [1, 1, 0, 0, 1, 1, 0, 0, 1, 1],
      [1, 1, 1, 1, 1, 1, 1, 1, 1, 1]
      ]
     },
     {
     "level_id" : 30,
     "matrix" :
                                     [
                                      [1, 1, 1, 1, 1, 1, 1, 1, 1, 1],
                                      [1, 2, 0, 0, 1, 3, 0, 0, 0, 1],
                                      [1, 0, 1, 0, 0, 0, 0, 0, 1, 1],
                                      [1, 0, 1, 0, 0, 0, 0, 0, 0, 1],
                                      [1, 0, 0, 0, 0, 0, 1, 1, 0, 1],
                                      [1, 0, 1, 0, 0, 0, 0, 0, 0, 1],
                                      [1, 0, 1, 1, 1, 0, 0, 0, 0, 1],
                                      [1, 0, 1, 3, 0, 0, 0, 0, 0, 1],
                                      [1, 0, 0, 0, 0, 0, 1, 1, 0, 1],
                                      [1, 0, 1, 0, 0, 0, 0, 0, 0, 1],
                                      [1, 0, 1, 0, 0, 0, 0, 0, 1, 1],
                                      [1, 2, 0, 0, 0, 1, 0, 0, 0, 1],
                                      [1, 1, 1, 1, 1, 1, 1, 1, 1, 1]
                                      ]
     },
     {
     "level_id" : 31,
     "matrix" :
                                                                         [
                                                                          [1, 1, 1, 1, 1, 1, 1, 1, 1, 1],
                                                                          [1, 2, 0, 1, 0, 0, 0, 0, 3, 1],
                                                                          [1, 0, 0, 0, 0, 0, 0, 1, 1, 1],
                                                                          [1, 1, 1, 1, 0, 1, 0, 0, 3, 1],
                                                                          [1, 0, 0, 0, 0, 1, 0, 0, 0, 1],
                                                                          [1, 0, 0, 0, 0, 1, 0, 0, 0, 1],
                                                                          [1, 0, 0, 0, 1, 1, 0, 0, 1, 1],
                                                                          [1, 0, 0, 0, 0, 0, 0, 0, 1, 1],
                                                                          [1, 0, 0, 0, 1, 1, 0, 0, 0, 1],
                                                                          [1, 1, 1, 0, 0, 1, 0, 0, 0, 1],
                                                                          [1, 0, 0, 0, 0, 0, 0, 1, 1, 1],
                                                                          [1, 2, 0, 1, 0, 0, 0, 0, 0, 1],
                                                                          [1, 1, 1, 1, 1, 1, 1, 1, 1, 1]
                                                                          ]
     },
     {
     "level_id" : 32,
     "matrix" :
                                                                                                             [
                                                                                                              [1, 1, 1, 1, 1, 1, 1, 1, 1, 1],
                                                                                                              [1, 2, 0, 0, 0, 1, 0, 0, 0, 1],
                                                                                                              [1, 0, 0, 1, 0, 1, 0, 0, 0, 1],
                                                                                                              [1, 0, 0, 1, 0, 0, 0, 1, 1, 1],
                                                                                                              [1, 1, 0, 0, 0, 0, 0, 0, 3, 1],
                                                                                                              [1, 0, 0, 1, 0, 0, 1, 1, 0, 1],
                                                                                                              [1, 0, 0, 3, 0, 0, 0, 0, 0, 1],
                                                                                                              [1, 0, 1, 0, 1, 1, 0, 0, 0, 1],
                                                                                                              [1, 0, 0, 0, 0, 0, 0, 1, 1, 1],
                                                                                                              [1, 0, 0, 1, 0, 0, 0, 0, 0, 1],
                                                                                                              [1, 1, 0, 1, 0, 0, 0, 1, 0, 1],
                                                                                                              [1, 1, 0, 0, 0, 0, 0, 1, 2, 1],
                                                                                                              [1, 1, 1, 1, 1, 1, 1, 1, 1, 1]
                                                                                                              ]
     }
     ]
}
